-----Q--Q-----tQ----------Q----tQ----Q--------Q--Q--Q---Q-------Q----Q----------------Q--Q----Q-----------Q---Q---------
-----Q----Q-Q-Q--Q-Q-Q-QQ---Q-Q---Q----QQ-Q-Q---------Q---QQQ-Q-Q-Q----Q-Q-Q-Q-Q-Q-Q-Q-Q--Q-QQQ-Q-Q-Q-QQQ-Q-Q---Q-QQt---
-------Q--------Q---------Q---Q-Q---Q-Q-------Q-Q-Q-QQ-QQQ----------Q-Q-------Q-Q------Q-------Q---Q----------QQ--------
----Q-Q--Q-QQ-Q---Q-Q-Q-Q--Q------Q----Q-Q-QQ-Q------Q-----Q-Q-Q-QQ-----Q-Q-Q----Q-Q-Q---Q-Q-Q-Q-QQ--Q-Q-Q-Q-Q---Q-Q----
--------Q--Q-Q--Q-------Q----Q-Q-Q--Q-----------Q-Q----Q-Q------Q---Q-Q------Q-Q-------Q--Q---Q-----------Q----Q-Q--Q---
---Q-Q-Q---Q---Q--QQQ-Q---Q-Q------Q--Q-Q-Q-QQ-Q-Q-Q-Q---Q-QQ-Q---Q-----Q-Q------Q-Q-Q------Q---Q-Q-Q-Q-Q---Q-Q-Q-------
------Q--Q--Q-Q-Q-------Q----Q-Q-Q-Q-Q-----Q-----------QQ-------Q---Q-Q-Q---Q-Q-Q------Q-Q--Q-Q---Q-Q-Q-Q-QQ------QQt---
----Q--Q-Q--Q-----Q-Q-Q---QQ------Q--Q-Q-Q--Q-Q-Q-Q-Q--Q--Q-Q-Q---Q-------Q-------Q-Q-Q---------Q----------Q-Q-Q-Q------
-----QQ-------QQQ-------Q----Q-QQ-Q-------Q-XQ---------Q-Q---Q--Q---Q-Q-QQ-Q-Q-Q-Q---Q--Q-Q-Q-Q---Q-Q-QQ-Q---------Q----
---Q----Q-Q-Q-----Q-Q-QQ--Q-Q---Q---Q-QQQ------Q-Q-QQ-----Q----Q--Q------------Q---Q---Q-Q------Q----Q--Q--Q-Q-Q-Q------
-----Q--Q-----Q-Q------Q------Q-Q-Q-------Q-Q-Q---Q---Q-Q--Q-Q------Q-QQ-Q-Q-Q---Q---Q--Q--Q-Q-Q--Q-------Q-------Q-----
-M--Q-----Q-Q-----Q-Q-QQ-Q-Q-Q-----QQ-Q-Q-------Q-Q-Q---Q-Q---Q-Q-QQ-----------Q---Q--Q----Q-----Q--Q-Q-Q---Q-Q-Q-----F-
XXX--Q-Q-Q----QQ-Q-------------Q-Q--------Q-Q-Q-------Q-----Q------XQ-Q-Q-Q-Q-Q--Q------Q-Q--Q-Q-Q-Q------Q-------Q---X-
XXXQQXQXQXQQQQXtQXQQQQQQQQQQQQQXQXQQQQQQQQXQXQXQQQQQQQXQQQQQXQQQQQQXXQXQXQXQXQXQQXQQQQQQXQXQQXQXQXQXQQQQQQXQQQQQQQXQtXXX